11 18

1 1 1 1 1 0 0 0 0 0 0 0 0 0 0 0 0 0

1 0 0 0 1 1 1 1 1 0 0 0 0 0 0 0 0 0

1 0 2 0 0 0 0 0 1 0 0 1 1 1 1 1 0 0

1 0 2 1 0 5 1 0 1 1 1 1 4 0 4 1 1 1

1 0 2 0 2 1 1 0 1 0 0 0 0 0 4 4 4 1

1 1 1 2 0 0 0 0 1 0 0 1 1 0 4 4 4 1

0 0 1 0 0 0 0 2 0 0 0 0 1 1 0 1 1 1

0 0 1 1 1 1 0 0 1 1 2 2 0 0 0 1 0 0

0 0 0 0 0 1 1 1 1 1 0 0 1 1 1 1 0 0

0 0 0 0 0 0 0 0 0 1 0 0 1 0 0 0 0 0

0 0 0 0 0 0 0 0 0 1 1 1 1 0 0 0 0 0